E E E E E E E E E E E E E 
E B E B E B E B E B E B E 
E B E B E B S B E B E B E 
E B E B E B E B E B E B E 
E B E B E E E E E B E B E 
E E E E E B E B E E E E E 
S E B B E B E B E B B E S 
E E E E E B B B E E E E E 
E B E B E B E B E B E B E 
E B E B E B E B E B E B E 
E B E B E E E E E B E B E 
E B E B E B B B E B E B E
E E E E E B E B E E E E E