E E E E E E E E E E E E E
E E E E E E E E E E E E E
E E E E E E E E E E E E E
G G G G R R R R G G G G G
E E E E E E E E E E E E E
E E E E E B B E E E E E E
E B B B E B B E B B B E E
E B E E E E E E E E E B B
E B B E S S S S E E B B E
E E B B E E E E E B B E E
E E E B B E E E B B E E E
E E E E E B S B E E E E E
E E E E B B H B E E E E E